R 640 480
NO ./textures/greystone.xpm
SO ./textures/wood.xpm
WE ./textures/colorstone.xpm
EA ./textures/redbrick.xpm

S ./textures/barrel.xpm
F 47,79,79
C 72,61,139

        1111111111111111111111111
        1000000000110000000000001
        1011000001110000002000001
        100100000W000000000000001
111111111011020001110000000000001
100000000011000001110111111111111
11110111111111011100000010001
11110111111111011101010010001
11000000110101011100000010001
10002000000000001100000010001
10000000000000001101010010001
1100000111010101111101111000111
11110111 1110101 101111010001
11111111 1111111 111111111111
